11111111
110P0001
1E00C001
11000001
11111111
