11111111
110P0001
1E10C001
11000001
11111111
